3 3 3 3 3 3 3 3 3 3 3 3 3 3 3 3 3 3 3 3 3 3 3 3 3 3 3 3 3 3 3 3 3 3 3 3 3 3 3 3 3 3 3 3 3 3 3 3
3 0 0 0 0 5 0 0 0 5 0 0 0 4 0 0 14 0 0 0 4 0 4 0 0 6 6 0 0 0 0 0 2 0 0 6 0 0 0 0 0 0 0 4 0 0 0 3
3 0 1 0 0 0 0 0 0 0 0 4 4 4 0 0 0 0 0 23 3 3 3 16 0 0 6 0 23 0 0 0 4 0 0 0 23 0 0 0 14 0 4 0 0 0 0 3
3 0 0 0 23 23 0 0 0 5 0 0 24 0 0 0 0 0 0 0 0 0 4 4 0 0 0 0 0 0 24 0 0 4 0 0 0 0 12 9 9 9 9 9 13 0 0 3
3 0 0 0 0 0 0 0 0 0 0 3 0 0 0 6 6 0 0 0 0 23 24 0 0 0 23 0 0 4 4 4 4 0 0 23 0 0 8 19 19 19 19 19 8 0 0 3
3 0 0 0 6 0 0 6 0 0 0 3 0 3 0 0 0 0 0 4 4 4 3 0 4 0 0 0 0 0 0 6 0 0 0 0 0 0 8 20 20 20 20 20 8 0 0 3
3 0 0 0 0 0 0 23 23 0 0 3 0 3 0 0 0 23 0 0 0 4 0 0 5 0 0 23 0 0 6 0 0 0 23 0 0 0 8 21 21 21 21 21 8 0 0 3
3 3 3 3 3 3 3 3 3 0 0 0 3 0 0 3 0 0 4 4 0 0 23 0 0 6 0 0 0 14 0 0 5 0 0 0 0 0 8 22 22 22 22 22 8 0 0 3
3 0 0 0 0 0 0 0 3 0 23 3 0 0 0 24 0 0 0 0 0 0 0 0 4 4 4 4 0 0 0 0 0 0 0 0 0 0 10 9 9 9 9 9 11 0 0 3
3 0 0 0 0 0 0 0 3 23 0 0 5 0 0 0 6 0 0 4 0 0 0 23 0 4 0 0 0 24 0 0 0 0 23 0 0 0 23 0 6 6 0 0 0 0 0 3
3 0 0 0 0 0 0 0 3 23 0 0 0 0 0 23 0 0 0 0 4 0 0 4 0 0 4 0 0 4 4 4 4 0 0 0 0 4 4 0 0 0 0 0 0 0 0 3
3 0 0 4 4 0 3 3 3 0 0 0 0 0 0 0 0 6 0 0 4 0 6 0 0 0 0 0 0 0 0 0 0 0 0 23 0 0 0 23 0 0 0 14 0 0 0 3
3 0 0 0 0 14 0 0 0 0 0 23 0 0 14 0 0 0 15 0 0 4 0 4 0 0 0 0 0 4 0 4 0 0 0 0 4 0 0 4 0 0 0 4 0 0 0 3
3 0 0 5 5 0 0 0 0 0 0 23 0 0 0 0 0 6 0 4 0 0 0 23 0 3 0 0 0 0 24 0 0 0 0 12 9 9 9 9 9 13 0 0 4 0 0 3
3 0 0 3 0 0 0 3 3 3 0 3 0 0 0 23 0 0 0 4 0 0 0 0 0 0 14 0 0 0 0 6 0 0 0 8 0 25 26 0 0 8 5 0 4 0 0 3
3 0 3 0 0 0 0 3 0 3 0 4 0 0 0 0 23 0 0 0 0 4 0 4 0 0 3 0 0 24 0 0 0 0 0 8 0 7 0 0 7 8 0 0 0 0 0 3
3 0 0 3 23 0 0 0 0 0 0 3 0 0 0 23 0 0 0 0 0 24 0 0 0 0 0 0 0 0 14 0 0 0 0 8 0 0 27 27 0 8 0 23 0 0 0 3
3 0 0 3 0 23 0 0 23 23 3 0 0 0 0 0 0 0 4 4 4 0 0 6 0 0 3 0 4 4 4 4 4 4 0 8 0 26 0 28 0 8 0 23 0 0 0 3
3 0 0 0 0 23 0 0 23 23 0 0 0 0 0 0 0 0 0 0 24 0 0 0 0 3 3 0 0 0 6 6 0 0 0 10 9 9 9 9 9 11 0 0 0 0 0 3
3 0 0 3 0 0 0 0 0 0 0 0 0 0 0 23 0 23 0 0 0 0 0 0 0 17 3 0 0 6 0 0 0 0 0 0 0 0 0 0 5 0 23 0 0 0 0 3
3 0 0 0 23 0 23 0 0 0 0 0 0 0 23 0 23 0 0 0 23 0 0 0 5 0 0 0 5 0 0 23 0 4 0 0 0 0 0 0 0 0 0 0 0 0 0 3
3 0 14 0 0 0 0 0 6 0 0 0 0 0 0 0 3 3 3 3 3 0 0 0 4 0 0 0 14 0 0 0 0 0 0 0 4 4 0 0 14 0 0 2 0 0 0 3
3 0 0 0 0 0 23 0 0 0 0 0 0 0 0 0 0 0 0 0 0 0 0 0 0 5 0 0 0 0 0 0 0 0 4 0 0 0 0 0 0 0 0 0 0 0 0 3
3 3 3 3 3 3 3 3 3 3 3 3 3 3 3 3 3 3 3 3 3 3 3 3 3 3 3 3 3 3 3 18 3 3 3 3 3 3 3 3 3 3 3 3 3 3 3 3